0 8 8 8 8 8 8 8 8 8 8 8 8 8 8 8 8 8 0
3 0 0 0 0 0 0 0 0 0 0 0 0 0 0 0 0 0 2
3 0 10 14 14 1 14 12 0 9 0 10 14 1 14 14 12 0 2
3 0 0 0 0 15 0 0 0 15 0 0 0 15 0 0 0 0 2
0 12 0 9 0 11 0 10 14 8 14 12 0 11 0 9 0 10 0
3 0 0 15 0 0 0 0 0 0 0 0 0 0 0 15 0 0 2
3 0 10 6 0 10 14 12 0 9 0 10 14 12 0 4 12 0 2
3 0 0 0 0 0 0 0 0 15 0 0 0 0 0 0 0 0 2
0 1 1 7 0 9 0 10 14 8 14 12 0 9 0 5 1 1 0
0 0 0 3 0 15 0 0 0 0 0 0 0 15 0 2 0 0 0
0 8 8 6 0 11 0 5 1 0 1 7 0 11 0 4 8 8 0
3 0 0 0 0 0 0 2 0 0 0 3 0 0 0 0 0 0 2
0 1 1 7 0 9 0 4 8 8 8 6 0 9 0 5 1 1 0
0 0 0 3 0 15 0 0 0 0 0 0 0 15 0 2 0 0 0
0 8 8 6 0 11 0 10 14 1 14 12 0 11 0 4 8 8 0
3 0 0 0 0 0 0 0 0 15 0 0 0 0 0 0 0 0 2
3 0 10 7 0 10 14 12 0 11 0 10 14 12 0 5 12 0 2 
3 0 0 15 0 0 0 0 0 0 0 0 0 0 0 15 0 0 2
0 12 0 11 0 9 0 10 14 1 14 12 0 9 0 11 0 10 0
3 0 0 0 0 15 0 0 0 15 0 0 0 15 0 0 0 0 2
3 0 10 14 14 8 14 12 0 11 0 10 14 8 14 14 12 0 2
3 0 0 0 0 0 0 0 0 0 0 0 0 0 0 0 0 0 2
0 1 1 1 1 1 1 1 1 1 1 1 1 1 1 1 1 1 0